20
9

    GGGGGGGGGGGG    
GGGGGGGGGGGGGGGGGGGG
CCCCCCCCWWWWCCCCCCCC
CCCCCCWWWWWCCCCCCCCC
CCCCCCCCCWWWWWCCCCCC
CCCCCCCWWWWWWCCCCCCC
WWCCCCCCWWWWCCCCCCWW
WWWWCCCCCCCCCCCCCWWW
