20
9
         
         GGGG
       GGGGGGG
      GGGGGGGGGG    
    GGGGGGGGGGGGG   
WWWWWWCCCCCCCCCWWWWW
WWWWWCCCCWWWCCCWWWWW
WWCCCCCCCWWWCCCCCWWW
WWCCCCCCWWWWWCCCCCWW
