20
9

GGGGGGGGGGGGGGGGGGGG
GGGGGGGGGGGGGGGGGGGG
WWCCCCWWWWWWWWWWWWWW
WWWCCCCCCCCCCCCCCCWW
WWWWWWWWWWWWWWWCCCCW
WWCCCCCCCCCCCCCCCCWW
WCCCCWWWWWWWWWWWWWWW
WWCCCCCCCCCCCCCCCCWW
