20
9

GGGGGGGGGGGGGGGGGGGG
CCCCCCCCCCCCCCCCCCCC
WWCCCCCCCCCCCCCCCCWW
WWWCCCCCCCCCCCCCCWWW
WWWWWCCCCCCCCCCCWWWW
WWWWWWWCCCCCCCWWWWWW
WWWWWWWWCCCCCWWWWWWW
WWWWWWWWWWWWWWWWWWWW
